is_invade,invade_timestamp,invade_kill_blue,invade_kill_red,invade_win_team,total_gold_blue_3_min,total_gold_red_3_min,gold_gap,gameMode
False,0,0,0,0,0,0,0,CLASSIC
False,0,0,0,0,0,0,0,CLASSIC
True,113544,0,1,200,4216,5094,-878,CLASSIC
False,0,0,0,0,0,0,0,CLASSIC
False,0,0,0,0,0,0,0,CLASSIC
False,0,0,0,0,0,0,0,CLASSIC
False,0,0,0,0,0,0,0,CLASSIC
False,0,0,0,0,0,0,0,CLASSIC
False,0,0,0,0,0,0,0,CLASSIC
False,0,0,0,0,0,0,0,CLASSIC
False,0,0,0,0,0,0,0,CLASSIC
True,112193,0,1,100,4419,5324,-905,CLASSIC
False,0,0,0,0,0,0,0,CLASSIC
False,0,0,0,0,0,0,0,CLASSIC
False,0,0,0,0,0,0,0,CLASSIC
False,0,0,0,0,0,0,0,CLASSIC
True,95344,3,0,100,5579,4008,1571,CLASSIC
True,105263,2,1,100,5063,4624,439,CLASSIC
False,0,0,0,0,0,0,0,CLASSIC
False,0,0,0,0,0,0,0,CLASSIC
False,0,0,0,0,0,0,0,CLASSIC
True,93590,1,0,100,4798,4289,509,CLASSIC
False,0,0,0,0,0,0,0,CLASSIC
False,0,0,0,0,0,0,0,CLASSIC
False,0,0,0,0,0,0,0,CLASSIC
True,66227,2,0,100,5910,4207,1703,CLASSIC
False,0,0,0,0,0,0,0,CLASSIC
True,88577,0,1,200,3825,5445,-1620,CLASSIC
False,0,0,0,0,0,0,0,CLASSIC
False,0,0,0,0,0,0,0,CLASSIC
True,46451,0,1,200,4948,4503,445,CLASSIC
True,62216,0,2,200,5053,5465,-412,CLASSIC
False,0,0,0,0,0,0,0,CLASSIC
False,0,0,0,0,0,0,0,CLASSIC
True,68739,0,2,200,4723,5108,-385,CLASSIC
True,103481,1,0,100,4908,4408,500,CLASSIC
False,0,0,0,0,0,0,0,CLASSIC
False,0,0,0,0,0,0,0,CLASSIC
True,96140,1,1,100,5081,4535,546,CLASSIC
False,0,0,0,0,0,0,0,CLASSIC
False,0,0,0,0,0,0,0,CLASSIC
False,0,0,0,0,0,0,0,CLASSIC
False,0,0,0,0,0,0,0,CLASSIC
False,0,0,0,0,0,0,0,CLASSIC
True,61481,1,0,200,4858,4474,384,CLASSIC
False,0,0,0,0,0,0,0,CLASSIC
False,0,0,0,0,0,0,0,CLASSIC
False,0,0,0,0,0,0,0,CLASSIC
False,0,0,0,0,0,0,0,CLASSIC
False,0,0,0,0,0,0,0,CLASSIC
False,0,0,0,0,0,0,0,CLASSIC
True,98819,2,0,100,5600,4562,1038,CLASSIC
True,101375,1,0,100,5365,3741,1624,CLASSIC
False,0,0,0,0,0,0,0,CLASSIC
False,0,0,0,0,0,0,0,CLASSIC
True,112460,1,0,100,4496,3976,520,CLASSIC
True,54482,1,0,100,5442,4641,801,CLASSIC
False,0,0,0,0,0,0,0,CLASSIC
False,0,0,0,0,0,0,0,CLASSIC
False,0,0,0,0,0,0,0,CLASSIC
True,113747,0,1,200,4769,5305,-536,CLASSIC
False,0,0,0,0,0,0,0,CLASSIC
False,0,0,0,0,0,0,0,CLASSIC
True,66861,1,0,200,4551,5887,-1336,CLASSIC
False,0,0,0,0,0,0,0,CLASSIC
False,0,0,0,0,0,0,0,CLASSIC
True,49414,3,0,200,5376,4169,1207,CLASSIC
False,0,0,0,0,0,0,0,CLASSIC
True,58325,0,1,200,4473,6462,-1989,CLASSIC
True,51678,0,2,200,4454,5031,-577,CLASSIC
False,0,0,0,0,0,0,0,CLASSIC
False,0,0,0,0,0,0,0,CLASSIC
False,0,0,0,0,0,0,0,CLASSIC
False,0,0,0,0,0,0,0,CLASSIC
False,0,0,0,0,0,0,0,CLASSIC
False,0,0,0,0,0,0,0,CLASSIC
True,68771,0,1,100,4552,4542,10,CLASSIC
True,114620,0,1,100,4431,4941,-510,CLASSIC
False,0,0,0,0,0,0,0,CLASSIC
False,0,0,0,0,0,0,0,CLASSIC
True,82415,0,1,100,4254,5047,-793,CLASSIC
False,0,0,0,0,0,0,0,CLASSIC
False,0,0,0,0,0,0,0,CLASSIC
False,0,0,0,0,0,0,0,CLASSIC
False,0,0,0,0,0,0,0,CLASSIC
False,0,0,0,0,0,0,0,CLASSIC
False,0,0,0,0,0,0,0,CLASSIC
False,0,0,0,0,0,0,0,CLASSIC
False,0,0,0,0,0,0,0,CLASSIC
False,0,0,0,0,0,0,0,CLASSIC
False,0,0,0,0,0,0,0,CLASSIC
False,0,0,0,0,0,0,0,CLASSIC
False,0,0,0,0,0,0,0,CLASSIC
True,113900,1,0,100,5004,4264,740,CLASSIC
False,0,0,0,0,0,0,0,CLASSIC
False,0,0,0,0,0,0,0,CLASSIC
True,74834,0,2,200,4360,5353,-993,CLASSIC
False,0,0,0,0,0,0,0,CLASSIC
False,0,0,0,0,0,0,0,CLASSIC
True,39432,1,0,100,4740,3857,883,CLASSIC
False,0,0,0,0,0,0,0,CLASSIC
False,0,0,0,0,0,0,0,CLASSIC
False,0,0,0,0,0,0,0,CLASSIC
False,0,0,0,0,0,0,0,CLASSIC
False,0,0,0,0,0,0,0,CLASSIC
True,119040,0,1,100,4020,4630,-610,CLASSIC
False,0,0,0,0,0,0,0,CLASSIC
False,0,0,0,0,0,0,0,CLASSIC
False,0,0,0,0,0,0,0,CLASSIC
True,46930,1,1,200,4777,4978,-201,CLASSIC
False,0,0,0,0,0,0,0,CLASSIC
False,0,0,0,0,0,0,0,CLASSIC
False,0,0,0,0,0,0,0,CLASSIC
True,52583,0,1,200,4181,5352,-1171,CLASSIC
False,0,0,0,0,0,0,0,CLASSIC
True,51829,1,0,200,5340,4609,731,CLASSIC
False,0,0,0,0,0,0,0,CLASSIC
False,0,0,0,0,0,0,0,CLASSIC
False,0,0,0,0,0,0,0,CLASSIC
True,52441,0,1,200,4485,4789,-304,CLASSIC
False,0,0,0,0,0,0,0,CLASSIC
False,0,0,0,0,0,0,0,CLASSIC
False,0,0,0,0,0,0,0,CLASSIC
False,0,0,0,0,0,0,0,CLASSIC
False,0,0,0,0,0,0,0,CLASSIC
False,0,0,0,0,0,0,0,CLASSIC
False,0,0,0,0,0,0,0,CLASSIC
False,0,0,0,0,0,0,0,CLASSIC
False,0,0,0,0,0,0,0,CLASSIC
True,39575,1,2,200,4701,5786,-1085,CLASSIC
True,43962,0,2,100,4318,6143,-1825,CLASSIC
False,0,0,0,0,0,0,0,CLASSIC
False,0,0,0,0,0,0,0,CLASSIC
True,100800,1,0,100,5360,4129,1231,CLASSIC
True,86456,1,1,100,4724,4723,1,CLASSIC
False,0,0,0,0,0,0,0,CLASSIC
False,0,0,0,0,0,0,0,CLASSIC
False,0,0,0,0,0,0,0,CLASSIC
False,0,0,0,0,0,0,0,CLASSIC
False,0,0,0,0,0,0,0,CLASSIC
False,0,0,0,0,0,0,0,CLASSIC
False,0,0,0,0,0,0,0,CLASSIC
False,0,0,0,0,0,0,0,CLASSIC
False,0,0,0,0,0,0,0,CLASSIC
True,83363,0,1,200,4465,5414,-949,CLASSIC
False,0,0,0,0,0,0,0,CLASSIC
False,0,0,0,0,0,0,0,CLASSIC
False,0,0,0,0,0,0,0,CLASSIC
False,0,0,0,0,0,0,0,CLASSIC
False,0,0,0,0,0,0,0,CLASSIC
True,50990,1,0,100,4974,4524,450,CLASSIC
False,0,0,0,0,0,0,0,CLASSIC
False,0,0,0,0,0,0,0,CLASSIC
True,72558,0,1,200,4032,5298,-1266,CLASSIC
False,0,0,0,0,0,0,0,CLASSIC
False,0,0,0,0,0,0,0,CLASSIC
True,40874,0,1,200,4294,5117,-823,CLASSIC
False,0,0,0,0,0,0,0,CLASSIC
False,0,0,0,0,0,0,0,CLASSIC
False,0,0,0,0,0,0,0,CLASSIC
False,0,0,0,0,0,0,0,CLASSIC
False,0,0,0,0,0,0,0,CLASSIC
False,0,0,0,0,0,0,0,CLASSIC
False,0,0,0,0,0,0,0,CLASSIC
False,0,0,0,0,0,0,0,CLASSIC
False,0,0,0,0,0,0,0,CLASSIC
False,0,0,0,0,0,0,0,CLASSIC
False,0,0,0,0,0,0,0,CLASSIC
False,0,0,0,0,0,0,0,CLASSIC
False,0,0,0,0,0,0,0,CLASSIC
False,0,0,0,0,0,0,0,CLASSIC
False,0,0,0,0,0,0,0,CLASSIC
False,0,0,0,0,0,0,0,CLASSIC
False,0,0,0,0,0,0,0,CLASSIC
False,0,0,0,0,0,0,0,CLASSIC
False,0,0,0,0,0,0,0,CLASSIC
False,0,0,0,0,0,0,0,CLASSIC
False,0,0,0,0,0,0,0,CLASSIC
False,0,0,0,0,0,0,0,CLASSIC
False,0,0,0,0,0,0,0,CLASSIC
False,0,0,0,0,0,0,0,CLASSIC
False,0,0,0,0,0,0,0,CLASSIC
False,0,0,0,0,0,0,0,CLASSIC
True,112501,0,1,100,4712,5022,-310,CLASSIC
True,50590,1,2,200,4011,6152,-2141,CLASSIC
False,0,0,0,0,0,0,0,CLASSIC
False,0,0,0,0,0,0,0,CLASSIC
False,0,0,0,0,0,0,0,CLASSIC
False,0,0,0,0,0,0,0,CLASSIC
False,0,0,0,0,0,0,0,CLASSIC
False,0,0,0,0,0,0,0,CLASSIC
True,38312,1,0,100,4812,4115,697,CLASSIC
True,111548,0,1,200,4726,5136,-410,CLASSIC
False,0,0,0,0,0,0,0,CLASSIC
False,0,0,0,0,0,0,0,CLASSIC
False,0,0,0,0,0,0,0,CLASSIC
False,0,0,0,0,0,0,0,CLASSIC
False,0,0,0,0,0,0,0,CLASSIC
False,0,0,0,0,0,0,0,CLASSIC
False,0,0,0,0,0,0,0,CLASSIC
True,108177,0,2,200,3920,5602,-1682,CLASSIC
False,0,0,0,0,0,0,0,CLASSIC
True,57348,0,1,200,4532,5110,-578,CLASSIC
False,0,0,0,0,0,0,0,CLASSIC
False,0,0,0,0,0,0,0,CLASSIC
False,0,0,0,0,0,0,0,CLASSIC
False,0,0,0,0,0,0,0,CLASSIC
False,0,0,0,0,0,0,0,CLASSIC
False,0,0,0,0,0,0,0,CLASSIC
False,0,0,0,0,0,0,0,CLASSIC
False,0,0,0,0,0,0,0,CLASSIC
True,47113,1,0,200,5071,4385,686,CLASSIC
False,0,0,0,0,0,0,0,CLASSIC
False,0,0,0,0,0,0,0,CLASSIC
True,64533,0,3,200,4414,5485,-1071,CLASSIC
False,0,0,0,0,0,0,0,CLASSIC
False,0,0,0,0,0,0,0,CLASSIC
False,0,0,0,0,0,0,0,CLASSIC
True,119781,1,0,200,6114,4818,1296,CLASSIC
False,0,0,0,0,0,0,0,CLASSIC
False,0,0,0,0,0,0,0,CLASSIC
False,0,0,0,0,0,0,0,CLASSIC
False,0,0,0,0,0,0,0,CLASSIC
False,0,0,0,0,0,0,0,CLASSIC
False,0,0,0,0,0,0,0,CLASSIC
False,0,0,0,0,0,0,0,CLASSIC
False,0,0,0,0,0,0,0,CLASSIC
False,0,0,0,0,0,0,0,CLASSIC
True,62909,1,0,100,5495,4202,1293,CLASSIC
True,47203,2,1,100,5292,5013,279,CLASSIC
True,58980,1,2,100,4888,5293,-405,CLASSIC
True,61325,1,0,100,5125,4374,751,CLASSIC
False,0,0,0,0,0,0,0,CLASSIC
False,0,0,0,0,0,0,0,CLASSIC
False,0,0,0,0,0,0,0,CLASSIC
True,118823,1,1,100,4689,4646,43,CLASSIC
True,106873,2,1,200,4836,4518,318,CLASSIC
False,0,0,0,0,0,0,0,CLASSIC
False,0,0,0,0,0,0,0,CLASSIC
False,0,0,0,0,0,0,0,CLASSIC
False,0,0,0,0,0,0,0,CLASSIC
False,0,0,0,0,0,0,0,CLASSIC
False,0,0,0,0,0,0,0,CLASSIC
False,0,0,0,0,0,0,0,CLASSIC
False,0,0,0,0,0,0,0,CLASSIC
False,0,0,0,0,0,0,0,CLASSIC
False,0,0,0,0,0,0,0,CLASSIC
False,0,0,0,0,0,0,0,CLASSIC
True,71299,1,0,200,5768,4975,793,CLASSIC
True,54024,0,1,200,4048,5133,-1085,CLASSIC
False,0,0,0,0,0,0,0,CLASSIC
False,0,0,0,0,0,0,0,CLASSIC
False,0,0,0,0,0,0,0,CLASSIC
False,0,0,0,0,0,0,0,CLASSIC
False,0,0,0,0,0,0,0,CLASSIC
True,56186,1,0,100,5049,4351,698,CLASSIC
False,0,0,0,0,0,0,0,CLASSIC
False,0,0,0,0,0,0,0,CLASSIC
False,0,0,0,0,0,0,0,CLASSIC
False,0,0,0,0,0,0,0,CLASSIC
False,0,0,0,0,0,0,0,CLASSIC
False,0,0,0,0,0,0,0,CLASSIC
False,0,0,0,0,0,0,0,CLASSIC
False,0,0,0,0,0,0,0,CLASSIC
False,0,0,0,0,0,0,0,CLASSIC
False,0,0,0,0,0,0,0,CLASSIC
False,0,0,0,0,0,0,0,CLASSIC
False,0,0,0,0,0,0,0,CLASSIC
False,0,0,0,0,0,0,0,CLASSIC
False,0,0,0,0,0,0,0,CLASSIC
False,0,0,0,0,0,0,0,CLASSIC
False,0,0,0,0,0,0,0,CLASSIC
False,0,0,0,0,0,0,0,CLASSIC
False,0,0,0,0,0,0,0,CLASSIC
True,117925,0,1,200,4270,4953,-683,CLASSIC
False,0,0,0,0,0,0,0,CLASSIC
False,0,0,0,0,0,0,0,CLASSIC
False,0,0,0,0,0,0,0,CLASSIC
False,0,0,0,0,0,0,0,CLASSIC
False,0,0,0,0,0,0,0,CLASSIC
False,0,0,0,0,0,0,0,CLASSIC
False,0,0,0,0,0,0,0,CLASSIC
True,53723,1,1,100,4566,4990,-424,CLASSIC
False,0,0,0,0,0,0,0,CLASSIC
False,0,0,0,0,0,0,0,CLASSIC
False,0,0,0,0,0,0,0,CLASSIC
False,0,0,0,0,0,0,0,CLASSIC
False,0,0,0,0,0,0,0,CLASSIC
False,0,0,0,0,0,0,0,CLASSIC
False,0,0,0,0,0,0,0,CLASSIC
False,0,0,0,0,0,0,0,CLASSIC
False,0,0,0,0,0,0,0,CLASSIC
False,0,0,0,0,0,0,0,CLASSIC
True,116812,1,0,100,4857,4233,624,CLASSIC
False,0,0,0,0,0,0,0,CLASSIC
False,0,0,0,0,0,0,0,CLASSIC
True,60599,1,2,200,4988,5758,-770,CLASSIC
False,0,0,0,0,0,0,0,CLASSIC
False,0,0,0,0,0,0,0,CLASSIC
False,0,0,0,0,0,0,0,CLASSIC
True,44368,2,3,200,6244,5458,786,CLASSIC
False,0,0,0,0,0,0,0,CLASSIC
False,0,0,0,0,0,0,0,CLASSIC
True,53081,0,1,100,4706,5242,-536,CLASSIC
False,0,0,0,0,0,0,0,CLASSIC
False,0,0,0,0,0,0,0,CLASSIC
False,0,0,0,0,0,0,0,CLASSIC
False,0,0,0,0,0,0,0,CLASSIC
False,0,0,0,0,0,0,0,CLASSIC
False,0,0,0,0,0,0,0,CLASSIC
False,0,0,0,0,0,0,0,CLASSIC
False,0,0,0,0,0,0,0,CLASSIC
False,0,0,0,0,0,0,0,CLASSIC
False,0,0,0,0,0,0,0,CLASSIC
False,0,0,0,0,0,0,0,CLASSIC
True,100229,1,0,200,4771,4747,24,CLASSIC
False,0,0,0,0,0,0,0,CLASSIC
False,0,0,0,0,0,0,0,CLASSIC
False,0,0,0,0,0,0,0,CLASSIC
False,0,0,0,0,0,0,0,CLASSIC
False,0,0,0,0,0,0,0,CLASSIC
True,48198,0,2,200,3995,5291,-1296,CLASSIC
False,0,0,0,0,0,0,0,CLASSIC
False,0,0,0,0,0,0,0,CLASSIC
True,67253,1,0,200,4770,4968,-198,CLASSIC
False,0,0,0,0,0,0,0,CLASSIC
True,51690,0,1,200,4853,4994,-141,CLASSIC
True,47181,1,2,200,4856,5564,-708,CLASSIC
False,0,0,0,0,0,0,0,CLASSIC
False,0,0,0,0,0,0,0,CLASSIC
False,0,0,0,0,0,0,0,CLASSIC
False,0,0,0,0,0,0,0,CLASSIC
False,0,0,0,0,0,0,0,CLASSIC
False,0,0,0,0,0,0,0,CLASSIC
True,43335,2,3,100,5087,5677,-590,CLASSIC
True,43318,1,0,100,5042,4398,644,CLASSIC
False,0,0,0,0,0,0,0,CLASSIC
False,0,0,0,0,0,0,0,CLASSIC
False,0,0,0,0,0,0,0,CLASSIC
True,102429,1,1,100,4590,4785,-195,CLASSIC
False,0,0,0,0,0,0,0,CLASSIC
True,41099,2,0,100,5219,4623,596,CLASSIC
False,0,0,0,0,0,0,0,CLASSIC
False,0,0,0,0,0,0,0,CLASSIC
False,0,0,0,0,0,0,0,CLASSIC
False,0,0,0,0,0,0,0,CLASSIC
False,0,0,0,0,0,0,0,CLASSIC
True,113440,1,0,100,4991,4618,373,CLASSIC
True,57349,0,1,200,4400,5438,-1038,CLASSIC
False,0,0,0,0,0,0,0,CLASSIC
False,0,0,0,0,0,0,0,CLASSIC
False,0,0,0,0,0,0,0,CLASSIC
False,0,0,0,0,0,0,0,CLASSIC
True,83585,0,1,100,4739,4695,44,CLASSIC
False,0,0,0,0,0,0,0,CLASSIC
True,115993,1,0,100,4816,4549,267,CLASSIC
False,0,0,0,0,0,0,0,CLASSIC
False,0,0,0,0,0,0,0,CLASSIC
True,45723,0,1,200,4489,4988,-499,CLASSIC
False,0,0,0,0,0,0,0,CLASSIC
False,0,0,0,0,0,0,0,CLASSIC
False,0,0,0,0,0,0,0,CLASSIC
False,0,0,0,0,0,0,0,CLASSIC
False,0,0,0,0,0,0,0,CLASSIC
False,0,0,0,0,0,0,0,CLASSIC
False,0,0,0,0,0,0,0,CLASSIC
False,0,0,0,0,0,0,0,CLASSIC
False,0,0,0,0,0,0,0,CLASSIC
False,0,0,0,0,0,0,0,CLASSIC
True,109649,1,0,100,5441,4348,1093,CLASSIC
False,0,0,0,0,0,0,0,CLASSIC
False,0,0,0,0,0,0,0,CLASSIC
False,0,0,0,0,0,0,0,CLASSIC
False,0,0,0,0,0,0,0,CLASSIC
False,0,0,0,0,0,0,0,CLASSIC
True,69733,0,1,200,4437,5072,-635,CLASSIC
True,63078,0,1,200,4393,5048,-655,CLASSIC
True,84865,1,0,100,5024,4843,181,CLASSIC
False,0,0,0,0,0,0,0,CLASSIC
True,114240,0,2,200,4172,5702,-1530,CLASSIC
False,0,0,0,0,0,0,0,CLASSIC
True,42745,2,1,100,6457,4886,1571,CLASSIC
False,0,0,0,0,0,0,0,CLASSIC
False,0,0,0,0,0,0,0,CLASSIC
True,111420,1,0,100,4742,4408,334,CLASSIC
False,0,0,0,0,0,0,0,CLASSIC
True,43629,0,1,200,4451,5333,-882,CLASSIC
False,0,0,0,0,0,0,0,CLASSIC
False,0,0,0,0,0,0,0,CLASSIC
False,0,0,0,0,0,0,0,CLASSIC
True,43852,0,1,200,4157,5289,-1132,CLASSIC
True,59295,0,2,200,3950,5329,-1379,CLASSIC
False,0,0,0,0,0,0,0,CLASSIC
True,43478,0,1,200,4581,5211,-630,CLASSIC
False,0,0,0,0,0,0,0,CLASSIC
False,0,0,0,0,0,0,0,CLASSIC
False,0,0,0,0,0,0,0,CLASSIC
False,0,0,0,0,0,0,0,CLASSIC
False,0,0,0,0,0,0,0,CLASSIC
False,0,0,0,0,0,0,0,CLASSIC
False,0,0,0,0,0,0,0,CLASSIC
False,0,0,0,0,0,0,0,CLASSIC
True,45688,0,1,200,4170,4955,-785,CLASSIC
False,0,0,0,0,0,0,0,CLASSIC
True,84595,2,0,100,5337,4300,1037,CLASSIC
False,0,0,0,0,0,0,0,CLASSIC
False,0,0,0,0,0,0,0,CLASSIC
False,0,0,0,0,0,0,0,CLASSIC
True,70391,0,1,200,4339,5125,-786,CLASSIC
True,94036,1,0,200,5107,4378,729,CLASSIC
False,0,0,0,0,0,0,0,CLASSIC
True,54473,0,3,200,4544,5569,-1025,CLASSIC
False,0,0,0,0,0,0,0,CLASSIC
False,0,0,0,0,0,0,0,CLASSIC
False,0,0,0,0,0,0,0,CLASSIC
False,0,0,0,0,0,0,0,CLASSIC
False,0,0,0,0,0,0,0,CLASSIC
True,118789,1,0,100,5526,4327,1199,CLASSIC
True,61229,0,2,100,4620,5076,-456,CLASSIC
True,46608,0,1,200,4614,5050,-436,CLASSIC
False,0,0,0,0,0,0,0,CLASSIC
False,0,0,0,0,0,0,0,CLASSIC
False,0,0,0,0,0,0,0,CLASSIC
True,109684,1,0,100,4907,4670,237,CLASSIC
True,48227,1,0,200,4832,4978,-146,CLASSIC
False,0,0,0,0,0,0,0,CLASSIC
True,38780,2,2,200,4991,5169,-178,CLASSIC
True,113181,0,1,100,4612,4968,-356,CLASSIC
False,0,0,0,0,0,0,0,CLASSIC
False,0,0,0,0,0,0,0,CLASSIC
False,0,0,0,0,0,0,0,CLASSIC
True,54468,1,0,200,5246,4378,868,CLASSIC
False,0,0,0,0,0,0,0,CLASSIC
False,0,0,0,0,0,0,0,CLASSIC
False,0,0,0,0,0,0,0,CLASSIC
False,0,0,0,0,0,0,0,CLASSIC
False,0,0,0,0,0,0,0,CLASSIC
False,0,0,0,0,0,0,0,CLASSIC
True,87578,1,0,100,5158,4857,301,CLASSIC
False,0,0,0,0,0,0,0,CLASSIC
False,0,0,0,0,0,0,0,CLASSIC
False,0,0,0,0,0,0,0,CLASSIC
False,0,0,0,0,0,0,0,CLASSIC
False,0,0,0,0,0,0,0,CLASSIC
True,64181,1,1,200,4835,5151,-316,CLASSIC
False,0,0,0,0,0,0,0,CLASSIC
True,40624,2,1,100,5685,5764,-79,CLASSIC
False,0,0,0,0,0,0,0,CLASSIC
False,0,0,0,0,0,0,0,CLASSIC
False,0,0,0,0,0,0,0,CLASSIC
False,0,0,0,0,0,0,0,CLASSIC
False,0,0,0,0,0,0,0,CLASSIC
True,55539,1,4,200,4791,6256,-1465,CLASSIC
False,0,0,0,0,0,0,0,CLASSIC
False,0,0,0,0,0,0,0,CLASSIC
False,0,0,0,0,0,0,0,CLASSIC
False,0,0,0,0,0,0,0,CLASSIC
True,115731,1,1,100,4404,4730,-326,CLASSIC
False,0,0,0,0,0,0,0,CLASSIC
True,112475,0,1,200,4727,5365,-638,CLASSIC
False,0,0,0,0,0,0,0,CLASSIC
False,0,0,0,0,0,0,0,CLASSIC
False,0,0,0,0,0,0,0,CLASSIC
False,0,0,0,0,0,0,0,CLASSIC
False,0,0,0,0,0,0,0,CLASSIC
True,57346,0,1,200,4385,5194,-809,CLASSIC
False,0,0,0,0,0,0,0,CLASSIC
True,52128,1,2,200,5051,5451,-400,CLASSIC
False,0,0,0,0,0,0,0,CLASSIC
False,0,0,0,0,0,0,0,CLASSIC
False,0,0,0,0,0,0,0,CLASSIC
False,0,0,0,0,0,0,0,CLASSIC
True,50704,2,1,100,5262,5790,-528,CLASSIC
False,0,0,0,0,0,0,0,CLASSIC
False,0,0,0,0,0,0,0,CLASSIC
False,0,0,0,0,0,0,0,CLASSIC
False,0,0,0,0,0,0,0,CLASSIC
False,0,0,0,0,0,0,0,CLASSIC
True,111944,1,2,100,4865,5011,-146,CLASSIC
False,0,0,0,0,0,0,0,CLASSIC
False,0,0,0,0,0,0,0,CLASSIC
True,110882,1,0,200,5420,5249,171,CLASSIC
False,0,0,0,0,0,0,0,CLASSIC
False,0,0,0,0,0,0,0,CLASSIC
False,0,0,0,0,0,0,0,CLASSIC
True,65634,0,1,100,5148,4919,229,CLASSIC
False,0,0,0,0,0,0,0,CLASSIC
False,0,0,0,0,0,0,0,CLASSIC
False,0,0,0,0,0,0,0,CLASSIC
False,0,0,0,0,0,0,0,CLASSIC
True,57835,1,3,100,5299,6361,-1062,CLASSIC
True,44996,2,0,100,5757,4466,1291,CLASSIC
True,53065,1,0,100,4878,4538,340,CLASSIC
True,69178,0,3,200,4239,5520,-1281,CLASSIC
False,0,0,0,0,0,0,0,CLASSIC
False,0,0,0,0,0,0,0,CLASSIC
True,46617,0,1,100,4342,4965,-623,CLASSIC
False,0,0,0,0,0,0,0,CLASSIC
True,118868,1,0,100,5972,3824,2148,CLASSIC
False,0,0,0,0,0,0,0,CLASSIC
False,0,0,0,0,0,0,0,CLASSIC
False,0,0,0,0,0,0,0,CLASSIC
True,65887,1,0,100,5037,4645,392,CLASSIC
False,0,0,0,0,0,0,0,CLASSIC
False,0,0,0,0,0,0,0,CLASSIC
False,0,0,0,0,0,0,0,CLASSIC
False,0,0,0,0,0,0,0,CLASSIC
False,0,0,0,0,0,0,0,CLASSIC
False,0,0,0,0,0,0,0,CLASSIC
False,0,0,0,0,0,0,0,CLASSIC
False,0,0,0,0,0,0,0,CLASSIC
False,0,0,0,0,0,0,0,CLASSIC
False,0,0,0,0,0,0,0,CLASSIC
False,0,0,0,0,0,0,0,CLASSIC
False,0,0,0,0,0,0,0,CLASSIC
True,118186,0,1,100,4350,4872,-522,CLASSIC
True,95097,0,1,200,4031,5594,-1563,CLASSIC
False,0,0,0,0,0,0,0,CLASSIC
False,0,0,0,0,0,0,0,CLASSIC
False,0,0,0,0,0,0,0,CLASSIC
False,0,0,0,0,0,0,0,CLASSIC
False,0,0,0,0,0,0,0,CLASSIC
False,0,0,0,0,0,0,0,CLASSIC
False,0,0,0,0,0,0,0,CLASSIC
False,0,0,0,0,0,0,0,CLASSIC
False,0,0,0,0,0,0,0,CLASSIC
False,0,0,0,0,0,0,0,CLASSIC
False,0,0,0,0,0,0,0,CLASSIC
False,0,0,0,0,0,0,0,CLASSIC
False,0,0,0,0,0,0,0,CLASSIC
True,102018,0,1,200,4415,5920,-1505,CLASSIC
False,0,0,0,0,0,0,0,CLASSIC
True,54433,4,5,100,6110,6235,-125,CLASSIC
True,45053,0,1,200,4889,5084,-195,CLASSIC
False,0,0,0,0,0,0,0,CLASSIC
False,0,0,0,0,0,0,0,CLASSIC
False,0,0,0,0,0,0,0,CLASSIC
False,0,0,0,0,0,0,0,CLASSIC
False,0,0,0,0,0,0,0,CLASSIC
False,0,0,0,0,0,0,0,CLASSIC
False,0,0,0,0,0,0,0,CLASSIC
False,0,0,0,0,0,0,0,CLASSIC
False,0,0,0,0,0,0,0,CLASSIC
True,52094,0,1,100,4704,4787,-83,CLASSIC
True,103481,0,3,200,3942,5928,-1986,CLASSIC
False,0,0,0,0,0,0,0,CLASSIC
True,107951,0,1,100,4412,5012,-600,CLASSIC
False,0,0,0,0,0,0,0,CLASSIC
True,62679,1,0,200,5301,4449,852,CLASSIC
False,0,0,0,0,0,0,0,CLASSIC
False,0,0,0,0,0,0,0,CLASSIC
True,109789,0,1,200,4261,5181,-920,CLASSIC
True,67135,0,2,100,5329,5979,-650,CLASSIC
False,0,0,0,0,0,0,0,CLASSIC
False,0,0,0,0,0,0,0,CLASSIC
False,0,0,0,0,0,0,0,CLASSIC
True,102274,0,1,200,4956,4693,263,CLASSIC
True,58364,1,0,100,4670,5223,-553,CLASSIC
False,0,0,0,0,0,0,0,CLASSIC
False,0,0,0,0,0,0,0,CLASSIC
False,0,0,0,0,0,0,0,CLASSIC
False,0,0,0,0,0,0,0,CLASSIC
False,0,0,0,0,0,0,0,CLASSIC
False,0,0,0,0,0,0,0,CLASSIC
False,0,0,0,0,0,0,0,CLASSIC
True,115883,1,0,100,4896,4517,379,CLASSIC
False,0,0,0,0,0,0,0,CLASSIC
False,0,0,0,0,0,0,0,CLASSIC
False,0,0,0,0,0,0,0,CLASSIC
False,0,0,0,0,0,0,0,CLASSIC
True,111252,1,1,200,4585,4889,-304,CLASSIC
False,0,0,0,0,0,0,0,CLASSIC
True,89057,1,1,100,4788,4484,304,CLASSIC
False,0,0,0,0,0,0,0,CLASSIC
False,0,0,0,0,0,0,0,CLASSIC
False,0,0,0,0,0,0,0,CLASSIC
False,0,0,0,0,0,0,0,CLASSIC
True,101267,2,0,100,5489,4130,1359,CLASSIC
False,0,0,0,0,0,0,0,CLASSIC
False,0,0,0,0,0,0,0,CLASSIC
False,0,0,0,0,0,0,0,CLASSIC
False,0,0,0,0,0,0,0,CLASSIC
False,0,0,0,0,0,0,0,CLASSIC
False,0,0,0,0,0,0,0,CLASSIC
True,40833,1,0,200,4925,4501,424,CLASSIC
False,0,0,0,0,0,0,0,CLASSIC
False,0,0,0,0,0,0,0,CLASSIC
True,96217,0,1,100,4088,4519,-431,CLASSIC
True,103934,0,2,200,4268,5356,-1088,CLASSIC
False,0,0,0,0,0,0,0,CLASSIC
True,69042,1,0,100,5057,4955,102,CLASSIC
False,0,0,0,0,0,0,0,CLASSIC
False,0,0,0,0,0,0,0,CLASSIC
False,0,0,0,0,0,0,0,CLASSIC
False,0,0,0,0,0,0,0,CLASSIC
False,0,0,0,0,0,0,0,CLASSIC
False,0,0,0,0,0,0,0,CLASSIC
False,0,0,0,0,0,0,0,CLASSIC
False,0,0,0,0,0,0,0,CLASSIC
False,0,0,0,0,0,0,0,CLASSIC
False,0,0,0,0,0,0,0,CLASSIC
False,0,0,0,0,0,0,0,CLASSIC
False,0,0,0,0,0,0,0,CLASSIC
True,65280,0,1,200,4555,4883,-328,CLASSIC
False,0,0,0,0,0,0,0,CLASSIC
False,0,0,0,0,0,0,0,CLASSIC
True,109995,1,0,200,4680,4913,-233,CLASSIC
False,0,0,0,0,0,0,0,CLASSIC
False,0,0,0,0,0,0,0,CLASSIC
False,0,0,0,0,0,0,0,CLASSIC
False,0,0,0,0,0,0,0,CLASSIC
False,0,0,0,0,0,0,0,CLASSIC
False,0,0,0,0,0,0,0,CLASSIC
True,40919,2,0,100,5968,4160,1808,CLASSIC
True,115970,0,2,200,4154,5180,-1026,CLASSIC
True,55240,1,0,100,4894,4701,193,CLASSIC
True,56677,0,1,200,4706,5376,-670,CLASSIC
True,96174,0,4,200,4259,6306,-2047,CLASSIC
True,51756,2,3,100,5837,5469,368,CLASSIC
False,0,0,0,0,0,0,0,CLASSIC
False,0,0,0,0,0,0,0,CLASSIC
True,112352,1,0,100,5062,4210,852,CLASSIC
False,0,0,0,0,0,0,0,CLASSIC
False,0,0,0,0,0,0,0,CLASSIC
False,0,0,0,0,0,0,0,CLASSIC
True,115924,1,0,100,4956,4564,392,CLASSIC
False,0,0,0,0,0,0,0,CLASSIC
True,46766,1,0,200,5207,4195,1012,CLASSIC
False,0,0,0,0,0,0,0,CLASSIC
False,0,0,0,0,0,0,0,CLASSIC
True,115913,1,0,100,4745,4253,492,CLASSIC
False,0,0,0,0,0,0,0,CLASSIC
True,90418,1,0,100,4652,4437,215,CLASSIC
False,0,0,0,0,0,0,0,CLASSIC
False,0,0,0,0,0,0,0,CLASSIC
False,0,0,0,0,0,0,0,CLASSIC
False,0,0,0,0,0,0,0,CLASSIC
True,119146,0,1,200,4672,5539,-867,CLASSIC
False,0,0,0,0,0,0,0,CLASSIC
False,0,0,0,0,0,0,0,CLASSIC
False,0,0,0,0,0,0,0,CLASSIC
True,40174,0,1,100,4502,5154,-652,CLASSIC
False,0,0,0,0,0,0,0,CLASSIC
False,0,0,0,0,0,0,0,CLASSIC
False,0,0,0,0,0,0,0,CLASSIC
False,0,0,0,0,0,0,0,CLASSIC
False,0,0,0,0,0,0,0,CLASSIC
False,0,0,0,0,0,0,0,CLASSIC
False,0,0,0,0,0,0,0,CLASSIC
False,0,0,0,0,0,0,0,CLASSIC
False,0,0,0,0,0,0,0,CLASSIC
False,0,0,0,0,0,0,0,CLASSIC
True,42803,1,0,200,5095,4658,437,CLASSIC
False,0,0,0,0,0,0,0,CLASSIC
False,0,0,0,0,0,0,0,CLASSIC
False,0,0,0,0,0,0,0,CLASSIC
False,0,0,0,0,0,0,0,CLASSIC
False,0,0,0,0,0,0,0,CLASSIC
False,0,0,0,0,0,0,0,CLASSIC
False,0,0,0,0,0,0,0,CLASSIC
True,78156,1,0,200,5039,4588,451,CLASSIC
False,0,0,0,0,0,0,0,CLASSIC
False,0,0,0,0,0,0,0,CLASSIC
False,0,0,0,0,0,0,0,CLASSIC
False,0,0,0,0,0,0,0,CLASSIC
False,0,0,0,0,0,0,0,CLASSIC
False,0,0,0,0,0,0,0,CLASSIC
True,66214,3,2,100,5242,5732,-490,CLASSIC
True,68862,0,1,100,4321,4830,-509,CLASSIC
False,0,0,0,0,0,0,0,CLASSIC
False,0,0,0,0,0,0,0,CLASSIC
False,0,0,0,0,0,0,0,CLASSIC
False,0,0,0,0,0,0,0,CLASSIC
True,44323,5,2,100,6988,5062,1926,CLASSIC
False,0,0,0,0,0,0,0,CLASSIC
False,0,0,0,0,0,0,0,CLASSIC
False,0,0,0,0,0,0,0,CLASSIC
True,50612,3,3,100,5686,5560,126,CLASSIC
False,0,0,0,0,0,0,0,CLASSIC
False,0,0,0,0,0,0,0,CLASSIC
False,0,0,0,0,0,0,0,CLASSIC
False,0,0,0,0,0,0,0,CLASSIC
False,0,0,0,0,0,0,0,CLASSIC
False,0,0,0,0,0,0,0,CLASSIC
False,0,0,0,0,0,0,0,CLASSIC
False,0,0,0,0,0,0,0,CLASSIC
False,0,0,0,0,0,0,0,CLASSIC
False,0,0,0,0,0,0,0,CLASSIC
False,0,0,0,0,0,0,0,CLASSIC
False,0,0,0,0,0,0,0,CLASSIC
True,58870,0,1,200,4644,4758,-114,CLASSIC
False,0,0,0,0,0,0,0,CLASSIC
False,0,0,0,0,0,0,0,CLASSIC
False,0,0,0,0,0,0,0,CLASSIC
False,0,0,0,0,0,0,0,CLASSIC
True,55330,1,1,200,4567,5175,-608,CLASSIC
False,0,0,0,0,0,0,0,CLASSIC
False,0,0,0,0,0,0,0,CLASSIC
False,0,0,0,0,0,0,0,CLASSIC
False,0,0,0,0,0,0,0,CLASSIC
False,0,0,0,0,0,0,0,CLASSIC
False,0,0,0,0,0,0,0,CLASSIC
False,0,0,0,0,0,0,0,CLASSIC
False,0,0,0,0,0,0,0,CLASSIC
False,0,0,0,0,0,0,0,CLASSIC
False,0,0,0,0,0,0,0,CLASSIC
False,0,0,0,0,0,0,0,CLASSIC
False,0,0,0,0,0,0,0,CLASSIC
True,110615,2,1,100,5379,4799,580,CLASSIC
False,0,0,0,0,0,0,0,CLASSIC
False,0,0,0,0,0,0,0,CLASSIC
False,0,0,0,0,0,0,0,CLASSIC
True,63565,0,2,200,4624,5050,-426,CLASSIC
False,0,0,0,0,0,0,0,CLASSIC
False,0,0,0,0,0,0,0,CLASSIC
True,74032,1,4,200,4732,5978,-1246,CLASSIC
False,0,0,0,0,0,0,0,CLASSIC
False,0,0,0,0,0,0,0,CLASSIC
False,0,0,0,0,0,0,0,CLASSIC
False,0,0,0,0,0,0,0,CLASSIC
False,0,0,0,0,0,0,0,CLASSIC
False,0,0,0,0,0,0,0,CLASSIC
False,0,0,0,0,0,0,0,CLASSIC
False,0,0,0,0,0,0,0,CLASSIC
False,0,0,0,0,0,0,0,CLASSIC
False,0,0,0,0,0,0,0,CLASSIC
False,0,0,0,0,0,0,0,CLASSIC
True,51805,0,1,100,4702,5107,-405,CLASSIC
True,55765,1,1,100,4841,5265,-424,CLASSIC
False,0,0,0,0,0,0,0,CLASSIC
False,0,0,0,0,0,0,0,CLASSIC
False,0,0,0,0,0,0,0,CLASSIC
True,78888,0,2,100,4093,5753,-1660,CLASSIC
False,0,0,0,0,0,0,0,CLASSIC
False,0,0,0,0,0,0,0,CLASSIC
False,0,0,0,0,0,0,0,CLASSIC
False,0,0,0,0,0,0,0,CLASSIC
True,60785,2,1,200,5604,5276,328,CLASSIC
False,0,0,0,0,0,0,0,CLASSIC
False,0,0,0,0,0,0,0,CLASSIC
False,0,0,0,0,0,0,0,CLASSIC
False,0,0,0,0,0,0,0,CLASSIC
True,90342,0,1,100,5067,4821,246,CLASSIC
False,0,0,0,0,0,0,0,CLASSIC
False,0,0,0,0,0,0,0,CLASSIC
False,0,0,0,0,0,0,0,CLASSIC
False,0,0,0,0,0,0,0,CLASSIC
False,0,0,0,0,0,0,0,CLASSIC
False,0,0,0,0,0,0,0,CLASSIC
False,0,0,0,0,0,0,0,CLASSIC
False,0,0,0,0,0,0,0,CLASSIC
False,0,0,0,0,0,0,0,CLASSIC
True,57926,0,1,100,4600,4829,-229,CLASSIC
False,0,0,0,0,0,0,0,CLASSIC
False,0,0,0,0,0,0,0,CLASSIC
False,0,0,0,0,0,0,0,CLASSIC
False,0,0,0,0,0,0,0,CLASSIC
False,0,0,0,0,0,0,0,CLASSIC
False,0,0,0,0,0,0,0,CLASSIC
False,0,0,0,0,0,0,0,CLASSIC
False,0,0,0,0,0,0,0,CLASSIC
False,0,0,0,0,0,0,0,CLASSIC
True,49325,1,0,100,4890,4630,260,CLASSIC
True,53253,1,0,100,5072,4598,474,CLASSIC
False,0,0,0,0,0,0,0,CLASSIC
False,0,0,0,0,0,0,0,CLASSIC
True,53136,0,1,200,4824,4982,-158,CLASSIC
False,0,0,0,0,0,0,0,CLASSIC
False,0,0,0,0,0,0,0,CLASSIC
False,0,0,0,0,0,0,0,CLASSIC
False,0,0,0,0,0,0,0,CLASSIC
False,0,0,0,0,0,0,0,CLASSIC
False,0,0,0,0,0,0,0,CLASSIC
False,0,0,0,0,0,0,0,CLASSIC
False,0,0,0,0,0,0,0,CLASSIC
False,0,0,0,0,0,0,0,CLASSIC
False,0,0,0,0,0,0,0,CLASSIC
False,0,0,0,0,0,0,0,CLASSIC
False,0,0,0,0,0,0,0,CLASSIC
False,0,0,0,0,0,0,0,CLASSIC
True,60967,3,0,100,6290,4139,2151,CLASSIC
False,0,0,0,0,0,0,0,CLASSIC
False,0,0,0,0,0,0,0,CLASSIC
False,0,0,0,0,0,0,0,CLASSIC
True,68454,1,0,200,4843,4312,531,CLASSIC
False,0,0,0,0,0,0,0,CLASSIC
False,0,0,0,0,0,0,0,CLASSIC
False,0,0,0,0,0,0,0,CLASSIC
True,57358,2,0,100,5395,5209,186,CLASSIC
False,0,0,0,0,0,0,0,CLASSIC
True,69245,1,0,100,4634,5270,-636,CLASSIC
False,0,0,0,0,0,0,0,CLASSIC
True,116518,0,1,100,5209,4319,890,CLASSIC
